1111111111111
10011C0000001
1E00010010011
1P000001C10C1
1111111111111