1111111111111
10011C0000001
1E00010010111
1P000001C00C1
111111111111