1111111111111
10011C0000001
1E00010010011
1P0X0001C00C1
1111111111111