1111111111111
1001000000001
1000011111001
100011E0C00C1
1111111111111