1111110111111
1001000000001
1000011111001
1P0011E0C00C1
1111111111111