1111111111111
100100000P001
1000011111001
1P0011E0C00C1
1111111111111