1111111111111
10E1000000001
1000011111001
1P0011E0C00C1
1111111111111