111111111111111111111111111111111111111
100011100000000000000000001111111100001
100000000000000000000000000000011111101
110000000001000000100000000000000000001
100011100000000000000000001111111100001
100000000000000000000000000000011111101
100011100000000000000000001111111100001
100000000000000000000000000000011111101
110000000001000000100000000000000000001
110000000001000000100000000000000000001
11111000001C000000100000000000000000001
1011000000001C0000010000000000000000001
1000000P00001C000010000E000000000000001
100000000000010000100000000000000000001
100111100000000000000000000000011111111
100011111111000000000001111111111111111
101101111111100000011111111111111111111
111111111111111100000C01111111111111111
111111111111111111111111111111111111111